Abiotrophia	X_Other
Acaricomes	X_Other
Acaryochloris	Cyanobacteria
Acetivibrio	X_Other
Acetobacter	Proteobacteria
Acetobacterium	Firmicutes
Acetohalobium	Firmicutes
Acetonema	X_Other
Acholeplasma	Firmicutes
Achromobacter	Proteobacteria
Aciculosporium	X_Other
Acidaminococcus	Firmicutes
Acidianus	Crenarchaeota
Acidilobus	Crenarchaeota
Acidimicrobium	Actinobacteria
Acidiphilium	Proteobacteria
Acidithiobacillus	Proteobacteria
Acidobacterium	Acidobacteria
Acidocella	X_Other
Acidothermus	Actinobacteria
Acidovorax	Proteobacteria
Aciduliprofundum	Euryarchaeota
Acinetobacter	Proteobacteria
Actinoalloteichus	X_Other
Actinobacillus	Proteobacteria
Actinobaculum	Actinobacteria
Actinokineospora	X_Other
Actinomadura	X_Other
Actinomyces	X_Other
Actinoplanes	Actinobacteria
Actinopolyspora	X_Other
Actinospica	X_Other
Actinosynnema	Actinobacteria
Adhaeribacter	X_Other
Adlercreutzia	Actinobacteria
Advenella	X_Other
Aequorivita	Bacteroidetes
Aerococcus	Firmicutes
Aeromicrobium	X_Other
Aeromonas	Proteobacteria
Aeropyrum	Crenarchaeota
Aestuariibacter	X_Other
Aestuariimicrobium	X_Other
Afipia	X_Other
Agarivorans	X_Other
Aggregatibacter	Proteobacteria
Agreia	X_Other
Agrobacterium	Proteobacteria
Agromyces	X_Other
Ahrensia	X_Other
Ajellomyces	X_Other
Akkermansia	Verrucomicrobia
Albugo	X_Other
Alcanivorax	Proteobacteria
Algoriphagus	X_Other
Alicycliphilus	Proteobacteria
Alicyclobacillus	Firmicutes
Aliihoeflea	X_Other
Aliivibrio	Proteobacteria
Alishewanella	X_Other
Alistipes	Bacteroidetes
Alkaliflexus	X_Other
Alkalilimnicola	Proteobacteria
Alkaliphilus	Firmicutes
Allobaculum	X_Other
Allochromatium	Proteobacteria
Alloprevotella	X_Other
Alloscardovia	X_Other
alpha	X_Other
Alphabaculovirus	X_Other
Alphacoronavirus	X_Other
Alphamesonivirus	X_Other
Alphavirus	X_Other
Alternaria	X_Other
Alteromonadales	Proteobacteria
Alteromonas	Proteobacteria
Aminobacter	X_Other
Aminobacterium	X_Other
Aminomonas	X_Other
Ammonifex	Firmicutes
Amorphus	X_Other
Amphibacillus	Firmicutes
Amphritea	X_Other
Amycolatopsis	Actinobacteria
Amycolicicoccus	Actinobacteria
Anabaena	Cyanobacteria
Anaeroarcus	X_Other
Anaerobaculum	X_Other
Anaerobiospirillum	X_Other
Anaerococcus	Firmicutes
Anaerofustis	X_Other
Anaerolinea	Chloroflexi
Anaeromusa	X_Other
Anaeromyxobacter	Proteobacteria
Anaerophaga	X_Other
Anaerostipes	X_Other
Anaerotruncus	X_Other
Anaplasma	Proteobacteria
Aneurinibacillus	X_Other
Anncaliia	X_Other
Anoxybacillus	Firmicutes
Aphanizomenon	X_Other
Aphanomyces	X_Other
Aphthovirus	X_Other
Aquamicrobium	X_Other
Aquareovirus	X_Other
Aquaspirillum	X_Other
Aquifex	X_Other
Aquimarina	X_Other
Arcanobacterium	Actinobacteria
Archaeoglobus	Euryarchaeota
Arcobacter	Proteobacteria
Arenibacter	X_Other
Arenimonas	X_Other
Arenitalea	X_Other
Aromatoleum	Proteobacteria
Arsenicicoccus	X_Other
Arterivirus	X_Other
Arthrobacter	Actinobacteria
Arthroderma	X_Other
Arthrospira	Cyanobacteria
Asaia	X_Other
Ascocoryne	X_Other
Ascogregarina	X_Other
Aspergillus	X_Other
Aster	X_Other
Asticcacaulis	Proteobacteria
Atadenovirus	X_Other
Atopobium	Actinobacteria
Atopococcus	X_Other
Aurantimonas	X_Other
Aureimonas	X_Other
Aureococcus	X_Other
Auricularia	X_Other
Austwickia	X_Other
Avulavirus	X_Other
Azoarcus	Proteobacteria
Azohydromonas	X_Other
Azorhizobium	Proteobacteria
Azospira	Proteobacteria
Azospirillum	Proteobacteria
Azotobacter	Proteobacteria
Azovibrio	X_Other
Bacilladnavirus	X_Other
Bacillarnavirus	X_Other
Bacillus	Firmicutes
Bacteriovorax	Proteobacteria
Bacteroides	Bacteroidetes
Bacteroidetes	Bacteroidetes
Balneola	X_Other
Barnesiella	Bacteroidetes
Bartonella	Proteobacteria
Basfia	Proteobacteria
Batrachochytrium	X_Other
Baumannia	Proteobacteria
Bdellovibrio	Proteobacteria
Beggiatoa	X_Other
Begomovirus	X_Other
Beijerinckia	Proteobacteria
Belliella	Bacteroidetes
Benyvirus	X_Other
Bergeyella	X_Other
Bermanella	X_Other
beta	X_Other
Betaretrovirus	X_Other
Beutenbergia	Actinobacteria
Bhargavaea	X_Other
Bibersteinia	Proteobacteria
Bifidobacterium	Actinobacteria
Bilophila	X_Other
Bipolaris	X_Other
Blastococcus	Actinobacteria
Blastocystis	X_Other
Blastopirellula	X_Other
Blattabacterium	Bacteroidetes
Blautia	X_Other
Blumeria	X_Other
Bordetella	Proteobacteria
Borrelia	W_Spirochaetes
Botryotinia	X_Other
Brachybacterium	Actinobacteria
Brachymonas	X_Other
Brachyspira	W_Spirochaetes
Bradyrhizobium	Proteobacteria
Brenneria	X_Other
Brevibacillus	Firmicutes
Brevibacterium	X_Other
Brevundimonas	Proteobacteria
Brucella	Proteobacteria
Bryantella	X_Other
Buchnera	Proteobacteria
Bulleidia	X_Other
Burkholderia	Proteobacteria
Burkholderiales	Proteobacteria
Butyricicoccus	X_Other
Butyricimonas	X_Other
Butyrivibrio	Firmicutes
C2likevirus	X_Other
Caenispirillum	X_Other
Caldanaerobacter	Firmicutes
Caldanaerobius	X_Other
Caldicellulosiruptor	Firmicutes
Caldicoprobacter	X_Other
Caldilinea	Chloroflexi
Caldimonas	X_Other
Caldisericum	X_Other
Caldisphaera	Crenarchaeota
Calditerrivibrio	X_Other
Caldithrix	X_Other
Caldivirga	Crenarchaeota
Calothrix	Cyanobacteria
Caminibacter	X_Other
Campylobacter	Proteobacteria
Campylobacterales	Proteobacteria
Candidatus_Accumulibacter	Proteobacteria
Candidatus_Amoebophilus	Bacteroidetes
Candidatus_Aquiluna	X_Other
Candidatus_Arthromitus	Firmicutes
Candidatus_Atelocyanobacterium	X_Other
Candidatus_Azobacteroides	Bacteroidetes
Candidatus_Blochmannia	Proteobacteria
Candidatus_Caldatribacteirum	X_Other
Candidatus_Carsonella	Proteobacteria
Candidatus_Chloracidobacterium	Acidobacteria
Candidatus_Desulforudis	Firmicutes
Candidatus_Glomeribacter	X_Other
Candidatus_Hamiltonella	Proteobacteria
Candidatus_Hodgkinia	Proteobacteria
Candidatus_Korarchaeum	X_Other
Candidatus_Koribacter	Acidobacteria
Candidatus_Latescibacter	X_Other
Candidatus_Liberibacter	Proteobacteria
Candidatus_Midichloria	Proteobacteria
Candidatus_Moranella	Proteobacteria
Candidatus_Nitrospira	Nitrospirae
Candidatus_Pelagibacter	Proteobacteria
Candidatus_Phytoplasma	Firmicutes
Candidatus_Protochlamydia	X_Other
Candidatus_Puniceispirillum	Proteobacteria
Candidatus_Regiella	X_Other
Candidatus_Rickettsia	Proteobacteria
Candidatus_Riesia	Proteobacteria
Candidatus_Ruthia	X_Other
Candidatus_Solibacter	Acidobacteria
Candidatus_Sulcia	Bacteroidetes
Candidatus_Symbiobacter	X_Other
Candidatus_Tremblaya	Proteobacteria
Candidatus_Vesicomyosocius	X_Other
Candidatus_Zinderia	Proteobacteria
Capnocytophaga	Bacteroidetes
Carboxydibrachium	X_Other
Carboxydothermus	Firmicutes
Cardiobacterium	X_Other
Cardoreovirus	X_Other
Carlavirus	X_Other
Carnobacterium	Firmicutes
Catellibacterium	X_Other
Catelliglobosispora	X_Other
Catenibacterium	X_Other
Catenovulum	X_Other
Catenulispora	Actinobacteria
Catonella	X_Other
Caulobacter	Proteobacteria
Cecembia	X_Other
Cellulomonas	Actinobacteria
Cellulophaga	Bacteroidetes
Cellulosilyticum	Firmicutes
Cellvibrio	Proteobacteria
Cenarchaeum	X_Other
Centipeda	X_Other
Cesiribacter	X_Other
Chamaesiphon	Cyanobacteria
Chelativorans	Proteobacteria
Chelatococcus	X_Other
Chitinibacter	X_Other
Chitinilyticum	X_Other
Chitinimonas	X_Other
Chitiniphilus	X_Other
Chitinophaga	Bacteroidetes
Chlamydia	X_Other
Chlamydophila	X_Other
Chlorobaculum	Chlorobi
Chlorobium	Chlorobi
Chloroflexus	Chloroflexi
Chloroherpeton	Chlorobi
Chromera	X_Other
Chromobacterium	Proteobacteria
Chromohalobacter	Proteobacteria
Chroococcidiopsis	Cyanobacteria
Chryseobacterium	Bacteroidetes
Chrysiogenes	X_Other
Chthoniobacter	X_Other
Chthonomonas	X_Other
Cilevirus	X_Other
Circovirus	X_Other
Citreicella	X_Other
Citrobacter	Proteobacteria
Citromicrobium	X_Other
Cladonia	X_Other
Clavibacter	Actinobacteria
Claviceps	X_Other
Cloacibacillus	X_Other
Clostridiales	Firmicutes
Clostridium	Firmicutes
Coccidioides	X_Other
Cohnella	X_Other
Coleofasciculus	X_Other
Colletotrichum	X_Other
Collimonas	Proteobacteria
Collinsella	X_Other
Coltivirus	X_Other
Colwellia	Proteobacteria
Comamonas	Proteobacteria
Commensalibacter	X_Other
Conexibacter	Actinobacteria
Congregibacter	X_Other
Coniosporium	X_Other
Coprobacillus	X_Other
Coprococcus	Firmicutes
Coprothermobacter	Firmicutes
Coraliomargarita	Verrucomicrobia
Corallococcus	Proteobacteria
Cordyceps	X_Other
Coriobacterium	Actinobacteria
Corynebacterium	Actinobacteria
Coxiella	Proteobacteria
Crinalium	Cyanobacteria
Crithidia	X_Other
Croceibacter	Bacteroidetes
Crocosphaera	X_Other
Cronartium	X_Other
Cronobacter	Proteobacteria
Cryptobacterium	Actinobacteria
Cryptosporangium	X_Other
Cucumibacter	X_Other
Cucumovirus	X_Other
Cupriavidus	Proteobacteria
Curtobacterium	X_Other
Curvibacter	X_Other
Cyanobacterium	Cyanobacteria
Cyanobium	Cyanobacteria
Cyanothece	Cyanobacteria
Cyclobacterium	Bacteroidetes
Cycloclasticus	Proteobacteria
Cylindrospermopsis	X_Other
Cylindrospermum	Cyanobacteria
Cypovirus	X_Other
Cystobacter	X_Other
Cytophaga	Bacteroidetes
Dactylococcopsis	Cyanobacteria
Dechloromonas	Proteobacteria
Dechlorosoma	X_Other
Deferribacter	Deferribacteres
Deferrisoma	X_Other
Dehalobacter	Firmicutes
Dehalobium	X_Other
Dehalococcoides	Chloroflexi
Dehalogenimonas	Chloroflexi
Deinococcus	X_Other
Delftia	Proteobacteria
Demetria	X_Other
Denitrovibrio	Deferribacteres
Dermabacter	X_Other
Dermacoccus	Actinobacteria
Dermatophilus	X_Other
Derxia	X_Other
Desmospora	X_Other
Desulfarculus	Proteobacteria
Desulfatibacillum	Proteobacteria
Desulfatirhabdium	X_Other
Desulfitobacterium	Firmicutes
Desulfobacca	Proteobacteria
Desulfobacter	X_Other
Desulfobacterium	Proteobacteria
Desulfobacula	Proteobacteria
Desulfobulbus	Proteobacteria
Desulfocapsa	Proteobacteria
Desulfococcus	Proteobacteria
Desulfocurvus	X_Other
Desulfohalobium	Proteobacteria
Desulfomicrobium	Proteobacteria
Desulfomonile	Proteobacteria
Desulfonatronospira	X_Other
Desulfonatronum	Proteobacteria
Desulfonauticus	X_Other
Desulfonema	X_Other
Desulforegula	X_Other
Desulfosarcina	X_Other
Desulfosporosinus	Firmicutes
Desulfotalea	Proteobacteria
Desulfotomaculum	Firmicutes
Desulfovibrio	Proteobacteria
Desulfurella	Proteobacteria
Desulfurispirillum	X_Other
Desulfurivibrio	Proteobacteria
Desulfurobacterium	X_Other
Desulfurococcus	Crenarchaeota
Desulfuromonas	X_Other
Dethiobacter	X_Other
Dethiosulfovibrio	X_Other
Dialister	X_Other
Dichelobacter	Proteobacteria
Dickeya	Proteobacteria
Dictyoglomus	X_Other
Dictyostelium	X_Other
Dielma	X_Other
Dietzia	X_Other
Dinoroseobacter	Proteobacteria
Dinovernavirus	X_Other
Diplosphaera	X_Other
Dokdonia	Bacteroidetes
Dolichospermum	X_Other
Dolosigranulum	X_Other
Dorea	X_Other
Duganella	X_Other
Dyadobacter	Bacteroidetes
Dyella	Proteobacteria
Dysgonomonas	X_Other
Echinicola	Bacteroidetes
Ectothiorhodospira	X_Other
Edhazardia	X_Other
Edwardsiella	Proteobacteria
Eggerthella	Actinobacteria
Eggerthia	X_Other
Ehrlichia	Proteobacteria
Eikenella	X_Other
Eimeria	X_Other
Elizabethkingia	X_Other
Elusimicrobium	Elusimicrobia
Emiliania	X_Other
Empedobacter	X_Other
Endocronartium	X_Other
Endornavirus	X_Other
Endozoicomonas	X_Other
Enhydrobacter	X_Other
Entamoeba	X_Other
Enterobacter	Proteobacteria
Enterobacteriaceae	Proteobacteria
Enterococcus	Firmicutes
Enterovirus	X_Other
Entomoplasma	X_Other
Epichloe	X_Other
Epilithonimonas	X_Other
Eremococcus	X_Other
Erwinia	Proteobacteria
Erysipelothrix	Firmicutes
Erysipelotrichaceae	Firmicutes
Erysiphe	X_Other
Erythrobacter	Proteobacteria
Escherichia	Proteobacteria
Ethanoligenens	Firmicutes
Eubacterium	Firmicutes
Exiguobacterium	Firmicutes
Facklamia	X_Other
Faecalibacterium	Firmicutes
Ferrimonas	Proteobacteria
Ferroglobus	Euryarchaeota
Fervidicoccus	Crenarchaeota
Fervidobacterium	X_Other
Fibrella	X_Other
Fibrobacter	X_Other
Fijivirus	X_Other
Filifactor	Firmicutes
Fimbriimonas	X_Other
Finegoldia	Firmicutes
Fischerella	X_Other
Flavivirus	X_Other
Flavobacteria	Bacteroidetes
Flavobacteriaceae	Bacteroidetes
Flavobacteriales	Bacteroidetes
Flavobacterium	Bacteroidetes
Flectobacillus	X_Other
Flexibacter	Bacteroidetes
Flexistipes	Deferribacteres
Fluoribacter	X_Other
Fluviicola	Bacteroidetes
Fodinicurvata	X_Other
Fomitiporia	X_Other
Fonticula	X_Other
Francisella	Proteobacteria
Frankia	Actinobacteria
Frateuria	Proteobacteria
Fructobacillus	X_Other
Fulvimarina	X_Other
Fulvivirga	X_Other
Fusarium	X_Other
Fusobacterium	X_Other
Gaetbulibacter	X_Other
Gaeumannomyces	X_Other
Gallibacterium	Proteobacteria
Gallionella	Proteobacteria
gamma	X_Other
Gamma	X_Other
Gammacoronavirus	X_Other
Gardnerella	Actinobacteria
Gayadomonas	X_Other
Geitlerinema	Cyanobacteria
Gelidibacter	X_Other
Gemella	X_Other
Geminicoccus	X_Other
Geminocystis	X_Other
Gemmata	X_Other
Gemmatimonas	Gemmatimonadetes
genus	X_Other
Geobacillus	Firmicutes
Geobacter	Proteobacteria
Geodermatophilus	Actinobacteria
Geopsychrobacter	X_Other
Geothrix	X_Other
Gilliamella	Proteobacteria
Gillisia	X_Other
Gilvimarinus	X_Other
Glaciecola	Proteobacteria
Glaciibacter	X_Other
Gloeobacter	Cyanobacteria
Gloeocapsa	Cyanobacteria
Gloeothece	X_Other
Gluconacetobacter	Proteobacteria
Gluconobacter	Proteobacteria
Glycomyces	X_Other
Gordonia	Actinobacteria
Gordonibacter	Actinobacteria
Gracilimonas	X_Other
Gramella	Bacteroidetes
Granulibacter	Proteobacteria
Granulicatella	X_Other
Granulicella	Acidobacteria
Grimontia	X_Other
Grosmannia	X_Other
Guignardia	X_Other
Gulosibacter	X_Other
Gyalolechia	X_Other
Haemophilus	Proteobacteria
Hafnia	X_Other
Hahella	Proteobacteria
Halalkalicoccus	Euryarchaeota
Halanaerobium	Firmicutes
Haliangium	Proteobacteria
Haliscomenobacter	Bacteroidetes
Haloarcula	Euryarchaeota
Halobacterium	Euryarchaeota
Halobiforma	X_Other
Halococcus	X_Other
Haloferax	Euryarchaeota
Halogeometricum	Euryarchaeota
Halogranum	X_Other
Halomicrobium	Euryarchaeota
Halomonas	Proteobacteria
Halonatronum	X_Other
Halonotius	X_Other
Halophilic	X_Other
Halopiger	Euryarchaeota
Haloplanus	X_Other
Haloquadratum	Euryarchaeota
Halorhabdus	Euryarchaeota
Halorhodospira	Proteobacteria
Halorubrum	Euryarchaeota
Haloterrigena	Euryarchaeota
Halothece	Cyanobacteria
Halothermothrix	Firmicutes
Halothiobacillus	Proteobacteria
Halovivax	Euryarchaeota
Hantavirus	X_Other
Helicobacter	Proteobacteria
Heliobacterium	Firmicutes
Henriciella	X_Other
Hepacivirus	X_Other
Herbaspirillum	Proteobacteria
Herminiimonas	Proteobacteria
Herpetosiphon	Chloroflexi
Hippea	Proteobacteria
Hirschia	Proteobacteria
Hirsutella	X_Other
Hoeflea	X_Other
Holdemania	X_Other
Holophaga	X_Other
Humibacter	X_Other
Hyaloperonospora	X_Other
Hydrogenivirga	X_Other
Hydrogenobacter	X_Other
Hydrogenobaculum	X_Other
Hymenobacter	Bacteroidetes
Hyperthermus	Crenarchaeota
Hyphochytrium	X_Other
Hyphomicrobium	Proteobacteria
Hyphomonas	Proteobacteria
Ichthyophthirius	X_Other
Idaeovirus	X_Other
Idiomarina	Proteobacteria
Ignicoccus	Crenarchaeota
Ignisphaera	Crenarchaeota
Ilumatobacter	Actinobacteria
Ilyobacter	X_Other
Influenzavirus_A	X_Other
Influenzavirus_C	X_Other
Intrasporangium	Actinobacteria
Isavirus	X_Other
Isoptericola	Actinobacteria
Isosphaera	Planctomycetes
Janibacter	X_Other
Jannaschia	Proteobacteria
Janthinobacterium	Proteobacteria
Jiangella	X_Other
Jonesia	Actinobacteria
Jonquetella	X_Other
Joostella	X_Other
Kaistia	X_Other
Kangiella	Proteobacteria
Kazachstania	X_Other
Ketogulonicigenium	Proteobacteria
Kiloniella	X_Other
Kineococcus	Actinobacteria
Kineosphaera	X_Other
Kingella	X_Other
Kitasatospora	Actinobacteria
Klebsiella	Proteobacteria
Kocuria	Actinobacteria
Komagataeibacter	X_Other
Kordia	X_Other
Kordiimonas	X_Other
Kosakonia	X_Other
Kosmotoga	X_Other
Kribbella	Actinobacteria
Krokinobacter	Bacteroidetes
Ktedonobacter	X_Other
Kurthia	X_Other
Kushneria	X_Other
Kyrpidia	Firmicutes
Kytococcus	Actinobacteria
L5likevirus	X_Other
Labrenzia	X_Other
Labyrnavirus	X_Other
Laccaria	X_Other
Laceyella	X_Other
Lachancea	X_Other
Lachnobacterium	X_Other
Lachnospira	X_Other
Lachnospiraceae	Firmicutes
Lacinutrix	Bacteroidetes
Lacticigenium	X_Other
Lactobacillus	Firmicutes
Lactococcus	Firmicutes
Lagovirus	X_Other
Lambdalikevirus	X_Other
Lamprocystis	X_Other
Laribacter	Proteobacteria
Lautropia	X_Other
Lawsonia	Proteobacteria
Leadbetterella	Bacteroidetes
Lebetimonas	X_Other
Leeia	X_Other
Leeuwenhoekiella	X_Other
Legionella	Proteobacteria
Leifsonia	Actinobacteria
Leishmania	X_Other
Leisingera	Proteobacteria
Lentibacillus	X_Other
Lentisphaera	X_Other
Lentivirus	X_Other
Leptolyngbya	Cyanobacteria
Leptonema	X_Other
Leptosphaeria	X_Other
Leptospira	W_Spirochaetes
Leptospirillum	Nitrospirae
Leptothrix	Proteobacteria
Leptotrichia	X_Other
Leucoagaricus	X_Other
Leuconostoc	Firmicutes
Leucothrix	X_Other
Lewinella	X_Other
Limnobacter	X_Other
Listeria	Firmicutes
Loktanella	X_Other
Luminiphilus	X_Other
Luteimonas	X_Other
Lutibaculum	X_Other
Lyngbya	X_Other
Lysinibacillus	Firmicutes
Lysobacter	X_Other
Macrococcus	Firmicutes
Macrophomina	X_Other
Magnaporthe	X_Other
Magnetococcus	Proteobacteria
Magnetospirillum	Proteobacteria
Mahella	Firmicutes
Mannheimia	Proteobacteria
Mardivirus	X_Other
Maribacter	Bacteroidetes
Maricaulis	Proteobacteria
Marichromatium	Proteobacteria
marine	X_Other
Marinilabilia	X_Other
Marinimicrobium	X_Other
Mariniradius	X_Other
Marinithermus	X_Other
Marinitoga	X_Other
Marinobacter	Proteobacteria
Marinobacterium	X_Other
Marinomonas	Proteobacteria
Mariprofundus	X_Other
Maritalea	X_Other
Maritimibacter	X_Other
Marivirga	Bacteroidetes
Marssonina	X_Other
Martelella	X_Other
Marvinbryantia	X_Other
Massilia	X_Other
Mastadenovirus	X_Other
Mastigocladopsis	X_Other
Mastigocoleus	X_Other
Megamonas	Firmicutes
Megasphaera	X_Other
Meiothermus	X_Other
Melampsora	X_Other
Melissococcus	Firmicutes
Melitea	X_Other
Mesoplasma	Firmicutes
Mesorhizobium	Proteobacteria
Mesotoga	X_Other
Metallosphaera	Crenarchaeota
Metarhizium	X_Other
Methanobacterium	Euryarchaeota
Methanobrevibacter	Euryarchaeota
Methanocaldococcus	Euryarchaeota
Methanocella	Euryarchaeota
Methanococcoides	Euryarchaeota
Methanococcus	Euryarchaeota
Methanocorpusculum	Euryarchaeota
Methanoculleus	Euryarchaeota
Methanofollis	X_Other
Methanogenium	X_Other
Methanohalobium	Euryarchaeota
Methanohalophilus	Euryarchaeota
Methanolinea	X_Other
Methanolobus	Euryarchaeota
Methanomassiliicoccus	Euryarchaeota
Methanoplanus	Euryarchaeota
Methanopyrus	Euryarchaeota
Methanoregula	Euryarchaeota
Methanosaeta	Euryarchaeota
Methanosalsum	Euryarchaeota
Methanosarcina	Euryarchaeota
Methanosphaera	Euryarchaeota
Methanosphaerula	Euryarchaeota
Methanospirillum	Euryarchaeota
Methanothermobacter	Euryarchaeota
Methanothermococcus	Euryarchaeota
Methanothermus	Euryarchaeota
Methanotorris	Euryarchaeota
Methylacidiphilum	Verrucomicrobia
Methylibium	Proteobacteria
Methylobacillus	Proteobacteria
Methylobacter	X_Other
Methylobacterium	Proteobacteria
Methylocapsa	X_Other
Methylocella	Proteobacteria
Methylococcus	Proteobacteria
Methylocystis	Proteobacteria
Methyloferula	X_Other
Methyloglobulus	X_Other
Methylomicrobium	Proteobacteria
Methylomonas	Proteobacteria
Methylophaga	Proteobacteria
Methylophilales	Proteobacteria
Methylophilus	X_Other
Methylosarcina	X_Other
Methylosinus	X_Other
Methylotenera	Proteobacteria
Methyloversatilis	X_Other
Methylovorus	Proteobacteria
Methylovulum	X_Other
Micavibrio	Proteobacteria
Microbacterium	Actinobacteria
Microbotryum	X_Other
Microbulbifer	X_Other
Microchaete	X_Other
Micrococcus	Actinobacteria
Microcoleus	Cyanobacteria
Microcystis	Cyanobacteria
Microlunatus	Actinobacteria
Micromonospora	Actinobacteria
Microscilla	X_Other
Microvirga	X_Other
Mimivirus	X_Other
Mimoreovirus	X_Other
Mitsuaria	X_Other
Mitsuokella	X_Other
Mobiluncus	Actinobacteria
Modestobacter	Actinobacteria
Mogibacterium	X_Other
Mollicutes	Firmicutes
Moorea	X_Other
Moorella	Firmicutes
Moraxella	Proteobacteria
Morganella	Proteobacteria
Moritella	X_Other
Mucilaginibacter	X_Other
Mucor	X_Other
Muricauda	Bacteroidetes
Myceliophthora	X_Other
Mycobacterium	Actinobacteria
Mycoplasma	Firmicutes
Mycoreovirus	X_Other
Myroides	X_Other
Myxococcus	Proteobacteria
N4likevirus	X_Other
Naegleria	X_Other
Nakamurella	Actinobacteria
Name	X_Other
Nannochloropsis	X_Other
Nanoarchaeum	Nanoarchaeota
Natranaerobius	Firmicutes
Natrialba	Euryarchaeota
Natrinema	Euryarchaeota
Natronobacterium	Euryarchaeota
Natronococcus	Euryarchaeota
Natronomonas	Euryarchaeota
Natronorubrum	X_Other
Naumovozyma	X_Other
Nautilia	Proteobacteria
ND	X_Other
Neisseria	Proteobacteria
Neorickettsia	Proteobacteria
Neotyphodium	X_Other
Nepovirus	X_Other
Neptunomonas	X_Other
Nesterenkonia	X_Other
Niabella	Bacteroidetes
Niastella	Bacteroidetes
Nisaea	X_Other
Nitratifractor	Proteobacteria
Nitratireductor	X_Other
Nitratiruptor	Proteobacteria
Nitrincola	X_Other
Nitritalea	X_Other
Nitrobacter	Proteobacteria
Nitrococcus	X_Other
Nitrolancea	X_Other
Nitrosococcus	Proteobacteria
Nitrosomonas	Proteobacteria
Nitrosopumilus	X_Other
Nitrosospira	Proteobacteria
Nitrospina	X_Other
Nitrospira	Nitrospirae
Nocardia	Actinobacteria
Nocardioides	Actinobacteria
Nocardiopsis	Actinobacteria
Nodosilinea	X_Other
Nodularia	X_Other
Nonlabens	Bacteroidetes
Nonomuraea	X_Other
Norovirus	X_Other
Nosema	X_Other
Nostoc	Cyanobacteria
'Nostoc	X_Other
Novispirillum	X_Other
Novosphingobium	Proteobacteria
Oceanibaculum	X_Other
Oceanibulbus	X_Other
Oceanicaulis	X_Other
Oceanicola	X_Other
Oceanimonas	Proteobacteria
Oceaniovalibus	X_Other
Oceanithermus	X_Other
Oceanobacillus	Firmicutes
Oceanobacter	X_Other
Oceanospirillum	X_Other
Ochrobactrum	Proteobacteria
Octadecabacter	Proteobacteria
Odoribacter	Bacteroidetes
Oenococcus	Firmicutes
Oleispira	X_Other
Oligella	X_Other
Oligotropha	Proteobacteria
Olivibacter	X_Other
Olsenella	Actinobacteria
OM252	X_Other
OM60	X_Other
Onion	X_Other
Ophiocordyceps	X_Other
Opitutus	Verrucomicrobia
Orbivirus	X_Other
Oribacterium	X_Other
Orientia	Proteobacteria
Ornithinibacillus	X_Other
Ornithinimicrobium	X_Other
Ornithobacterium	Bacteroidetes
Orpinomyces	X_Other
Orthoreovirus	X_Other
Oscillatoria	Cyanobacteria
Oscillibacter	Firmicutes
Oscillochloris	X_Other
Ourmiavirus	X_Other
Owenweeksia	Bacteroidetes
Oxalobacter	Proteobacteria
Paenibacillus	Firmicutes
Paenisporosarcina	X_Other
Paludibacter	Bacteroidetes
Paludibacterium	X_Other
Pandoraea	Proteobacteria
Pannonibacter	X_Other
Pantoea	Proteobacteria
Parabacteroides	Bacteroidetes
Parachlamydia	X_Other
Paracoccidioides	X_Other
Paracoccus	Proteobacteria
Paramecium	X_Other
Paraprevotella	X_Other
Parascardovia	X_Other
Parastagonospora	X_Other
Parasutterella	X_Other
Parvibaculum	Proteobacteria
Parvimonas	X_Other
Parvularcula	Proteobacteria
Passalora	X_Other
Pasteurella	Proteobacteria
Patulibacter	X_Other
Pectobacterium	Proteobacteria
Pediococcus	Firmicutes
Pedobacter	Bacteroidetes
Pedosphaera	X_Other
Pefudensovirus	X_Other
Pelagibacter	Proteobacteria
Pelagibacterium	Proteobacteria
Pelobacter	Proteobacteria
Pelodictyon	Chlorobi
Pelosinus	Firmicutes
Pelotomaculum	Firmicutes
Peptoclostridium	X_Other
Peptoniphilus	X_Other
Peptostreptococcus	X_Other
Perkinsus	X_Other
Persephonella	X_Other
Petrotoga	X_Other
Phaeobacter	Proteobacteria
Phaeospirillum	X_Other
Phanerochaete	X_Other
Phascolarctobacterium	X_Other
Phenylobacterium	Proteobacteria
Phikmvlikevirus	X_Other
Photobacterium	Proteobacteria
Photorhabdus	Proteobacteria
Phycisphaera	Planctomycetes
Phyllobacterium	X_Other
Physarum	X_Other
Phytomonas	X_Other
Phytophthora	X_Other
Phytoreovirus	X_Other
Picrophilus	Euryarchaeota
Pirellula	Planctomycetes
Piscirickettsia	X_Other
Planctomyces	Planctomycetes
Planktothrix	X_Other
Planococcus	X_Other
Plasmodium	X_Other
Pleomorphomonas	X_Other
Plesiocystis	X_Other
Pleurocapsa	Cyanobacteria
Polaribacter	Bacteroidetes
Polaromonas	Proteobacteria
Polemovirus	X_Other
Polymorphum	Proteobacteria
Polynucleobacter	Proteobacteria
Pontibacter	X_Other
Porphyrobacter	X_Other
Porphyromonas	Bacteroidetes
Postia	X_Other
Potexvirus	X_Other
Prevotella	Bacteroidetes
Prochlorococcus	Cyanobacteria
Prochlorothrix	X_Other
Promicromonospora	Actinobacteria
Propionibacterium	Actinobacteria
Propionicicella	X_Other
Propionimicrobium	X_Other
Prosthecochloris	Chlorobi
Proteiniphilum	X_Other
Proteus	Proteobacteria
Providencia	Proteobacteria
Prymnesiovirus	X_Other
Pseudacidovorax	X_Other
Pseudaminobacter	X_Other
Pseudanabaena	Cyanobacteria
Pseudoalteromonas	Proteobacteria
Pseudobutyrivibrio	X_Other
Pseudocercospora	X_Other
Pseudoclavibacter	X_Other
Pseudoflavonifractor	X_Other
Pseudogulbenkiania	Proteobacteria
Pseudogymnoascus	X_Other
Pseudomonas	Proteobacteria
Pseudonocardia	Actinobacteria
Pseudoramibacter	X_Other
Pseudovibrio	Proteobacteria
Pseudoxanthomonas	Proteobacteria
Psychrilyobacter	X_Other
Psychrobacter	Proteobacteria
Psychroflexus	Bacteroidetes
Psychromonas	Proteobacteria
Psychroserpens	X_Other
Puccinia	X_Other
Pusillimonas	Proteobacteria
Pyramidobacter	X_Other
Pyrenophora	X_Other
Pyrobaculum	Crenarchaeota
Pyrococcus	Euryarchaeota
Pyrolobus	Crenarchaeota
Rahnella	Proteobacteria
Ralstonia	Proteobacteria
Ramlibacter	Proteobacteria
Raoultella	Proteobacteria
Reinekea	X_Other
Renibacterium	Actinobacteria
Respirovirus	X_Other
Reticulomyxa	X_Other
Rheinheimera	X_Other
Rhizobium	Proteobacteria
Rhizoctonia	X_Other
Rhizophagus	X_Other
Rhizopus	X_Other
Rhodanobacter	Proteobacteria
Rhodobacter	Proteobacteria
Rhodobacteraceae	Proteobacteria
Rhodobacterales	Proteobacteria
Rhodococcus	Actinobacteria
Rhodocyclus	X_Other
Rhodoferax	X_Other
Rhodomicrobium	Proteobacteria
Rhodopirellula	Planctomycetes
Rhodopseudomonas	Proteobacteria
Rhodospirillum	Proteobacteria
Rhodothermus	Bacteroidetes
Rhodovibrio	X_Other
Rickettsia	Proteobacteria
Rickettsiella	X_Other
Riemerella	Bacteroidetes
Rikenella	Bacteroidetes
Rivularia	Cyanobacteria
Robiginitalea	Bacteroidetes
Roseburia	Firmicutes
Roseibacterium	Proteobacteria
Roseibium	X_Other
Roseiflexus	Chloroflexi
Roseobacter	Proteobacteria
Roseolovirus	X_Other
Roseomonas	X_Other
Roseovarius	X_Other
Rotavirus	X_Other
Rothia	Actinobacteria
Ruania	X_Other
Rubellimicrobium	X_Other
Rubidibacter	X_Other
Rubritalea	X_Other
Rubrivivax	Proteobacteria
Rubrobacter	Actinobacteria
Rudaea	X_Other
Rudanella	X_Other
Ruegeria	Proteobacteria
Ruminococcaceae	Firmicutes
Ruminococcus	Firmicutes
Runella	Bacteroidetes
Saccharibacillus	X_Other
Saccharomonospora	Actinobacteria
Saccharomyces	X_Other
Saccharophagus	Proteobacteria
Saccharopolyspora	Actinobacteria
Saccharospirillum	X_Other
Sagittula	X_Other
Salimicrobium	X_Other
Salinarimonas	X_Other
Salinibacter	Bacteroidetes
Salinibacterium	X_Other
Salinicoccus	X_Other
Salinimicrobium	X_Other
Salinimonas	X_Other
Salinispora	Actinobacteria
Salmonella	Proteobacteria
Salpingoeca	X_Other
Salterprovirus	X_Other
Sanguibacter	Actinobacteria
Saprolegnia	X_Other
Saprospira	Bacteroidetes
SAR11	Proteobacteria
Saxeibacter	X_Other
Scardovia	X_Other
Schizosaccharomyces	X_Other
Schlesneria	X_Other
Sciscionella	X_Other
Sclerotinia	X_Other
Scytonema	X_Other
Sebaldella	X_Other
Sedimentibacter	X_Other
Sediminibacterium	X_Other
Sediminimonas	X_Other
Segniliparus	Actinobacteria
Selenomonas	Firmicutes
Serpula	X_Other
Serratia	Proteobacteria
Setosphaeria	X_Other
Shewanella	Proteobacteria
Shigella	Proteobacteria
Shimazuella	X_Other
Shimwellia	X_Other
Shiraia	X_Other
Shuttleworthia	X_Other
Sideroxydans	Proteobacteria
Silanimonas	X_Other
Silicibacter	X_Other
Simiduia	Proteobacteria
Simkania	X_Other
Simonsiella	X_Other
Singularimonas	X_Other
Singulisphaera	Planctomycetes
Sinorhizobium	Proteobacteria
Skermanella	X_Other
Slackia	Actinobacteria
Smithella	X_Other
Sobemovirus	X_Other
Sodalis	Proteobacteria
Solibacillus	Firmicutes
Solitalea	Bacteroidetes
Solobacterium	X_Other
Sorangium	Proteobacteria
Sphaerobacter	Chloroflexi
Sphaerochaeta	X_Other
Sphaerulina	X_Other
Sphingobacterium	Bacteroidetes
Sphingobium	Proteobacteria
Sphingomonas	Proteobacteria
Sphingopyxis	Proteobacteria
Spiribacter	Proteobacteria
Spirochaeta	W_Spirochaetes
Spiroplasma	Firmicutes
Spirosoma	Bacteroidetes
Spirulina	X_Other
Sporichthya	X_Other
Sporocytophaga	X_Other
Sporolactobacillus	X_Other
Sporomusa	X_Other
Sporosarcina	X_Other
Stackebrandtia	Actinobacteria
Stanieria	Cyanobacteria
Staphylococcus	Firmicutes
Staphylothermus	Crenarchaeota
Stappia	X_Other
Starkeya	Proteobacteria
Stenotrophomonas	Proteobacteria
Sterkiella	X_Other
Stigmatella	Proteobacteria
Streptobacillus	X_Other
Streptococcus	Firmicutes
Streptomyces	Actinobacteria
Streptosporangium	Actinobacteria
Strigomonas	X_Other
Subdoligranulum	X_Other
Succinatimonas	X_Other
Succinimonas	X_Other
Sulfitobacter	X_Other
Sulfobacillus	Firmicutes
Sulfolobus	Crenarchaeota
Sulfuricella	Proteobacteria
Sulfuricurvum	Proteobacteria
Sulfurihydrogenibium	X_Other
Sulfurimonas	Proteobacteria
Sulfuritalea	Proteobacteria
Sulfurospirillum	Proteobacteria
Sulfurovum	Proteobacteria
Sutterella	X_Other
Symbiobacterium	Firmicutes
Symbiodinium	X_Other
Synechococcus	Cyanobacteria
Synechocystis	Cyanobacteria
Synergistetes	X_Other
Syntrophobacter	Proteobacteria
Syntrophobotulus	Firmicutes
Syntrophomonas	Firmicutes
Syntrophothermus	Firmicutes
Syntrophus	Proteobacteria
T4likevirus	X_Other
T5likevirus	X_Other
Tannerella	Bacteroidetes
Taylorella	Proteobacteria
Tenuivirus	X_Other
Tepidanaerobacter	Firmicutes
Tepidiphilus	X_Other
Teredinibacter	Proteobacteria
Terriglobus	Acidobacteria
Terrimonas	X_Other
Tetragenococcus	Firmicutes
Tetrahymena	X_Other
Thalassiobium	X_Other
Thalassobacter	X_Other
Thalassobaculum	X_Other
Thalassolituus	Proteobacteria
Thalassospira	X_Other
Thauera	Proteobacteria
Thermacetogenium	Firmicutes
Thermaerobacter	Firmicutes
Thermanaerovibrio	X_Other
Thermicanus	X_Other
Thermincola	Firmicutes
Thermithiobacillus	X_Other
Thermoanaerobacter	Firmicutes
Thermoanaerobacterium	Firmicutes
Thermobaculum	Chloroflexi
Thermobifida	Actinobacteria
Thermobispora	Actinobacteria
Thermobrachium	X_Other
Thermococcus	Euryarchaeota
Thermocrinis	X_Other
Thermodesulfatator	X_Other
Thermodesulfobacterium	X_Other
Thermodesulfobium	Firmicutes
Thermodesulfovibrio	Nitrospirae
Thermofilum	Crenarchaeota
Thermogladius	Crenarchaeota
Thermomicrobium	Chloroflexi
Thermomonospora	Actinobacteria
Thermophagus	X_Other
Thermoplasma	Euryarchaeota
Thermoproteus	Crenarchaeota
Thermosediminibacter	Firmicutes
Thermosinus	X_Other
Thermosipho	X_Other
Thermosphaera	Crenarchaeota
Thermosynechococcus	Cyanobacteria
Thermotoga	X_Other
Thermovibrio	X_Other
Thermovirga	X_Other
Thermus	X_Other
Thielavia	X_Other
Thioalkalimicrobium	Proteobacteria
Thioalkalivibrio	Proteobacteria
Thiobacillus	Proteobacteria
Thiocystis	Proteobacteria
Thioflavicoccus	Proteobacteria
Thiomicrospira	Proteobacteria
Thiomonas	Proteobacteria
Thioploca	Proteobacteria
Thiorhodococcus	X_Other
Thiorhodospira	X_Other
Thiorhodovibrio	X_Other
Thiothrix	X_Other
Thogotovirus	X_Other
Timonella	X_Other
Tistrella	Proteobacteria
Tolumonas	Proteobacteria
Tolypothrix	X_Other
Toxoplasma	X_Other
Tremella	X_Other
Treponema	W_Spirochaetes
Trichodesmium	Cyanobacteria
Trichomonas	X_Other
Trichophyton	X_Other
Trichormus	Cyanobacteria
Tropheryma	Actinobacteria
Truepera	X_Other
Trypanosoma	X_Other
Tsukamurella	Actinobacteria
Tuber	X_Other
Tunalikevirus	X_Other
Turicella	X_Other
Turicibacter	X_Other
Turneriella	W_Spirochaetes
Twortlikevirus	X_Other
Uliginosibacterium	X_Other
Umbravirus	X_Other
Uncultured	X_Other
Ureaplasma	Firmicutes
Ureibacillus	X_Other
Ustilago	X_Other
Varicellovirus	X_Other
Varicosavirus	X_Other
Variovorax	Proteobacteria
Veillonella	Firmicutes
Verminephrobacter	Proteobacteria
Verrucomicrobiales	Verrucomicrobia
Verrucomicrobium	X_Other
Verrucosispora	Actinobacteria
Vibrio	Proteobacteria
Vibrionales	Proteobacteria
Victivallis	X_Other
Viunalikevirus	X_Other
Vulcanisaeta	Crenarchaeota
Waddlia	X_Other
Weeksella	Bacteroidetes
Weissella	Firmicutes
Wenxinia	X_Other
Wigglesworthia	Proteobacteria
Williamsia	X_Other
Wohlfahrtiimonas	X_Other
Wolbachia	Proteobacteria
Wolfiporia	X_Other
Wolinella	Proteobacteria
Woodsholea	X_Other
wrong	X_Other
Xanthobacter	Proteobacteria
Xanthomonas	Proteobacteria
Xenorhabdus	Proteobacteria
Xylanibacter	X_Other
Xylanimonas	Actinobacteria
Xylella	Proteobacteria
Yaniella	X_Other
Yatapoxvirus	X_Other
Yersinia	Proteobacteria
Yokenella	X_Other
Youngiibacter	X_Other
Zavarzinella	X_Other
Zhouia	X_Other
Zobellia	Bacteroidetes
Zooshikella	X_Other
Zunongwangia	Bacteroidetes
Zymomonas	Proteobacteria
Zymoseptoria	X_Other
